11110000011110000011111110000000011111111100011111
00000000000011011000011000000000000000000000000000
00000000111010001100000011001100000000000110111111
00000000000000000000000000110000000000000000000000
00000000000000000001110000000000001111100000000000
11100011000000010000000000000000000000000000011111
00000000000000000000000000000000000000000000000000
00000000000000000000000000000000000000000000000000
11011000011000000000000000010111111111110101011111
10001110011000111110000000000000000000000000000000
00000000000100011111100000000000011000001100000000
01000011100110000000000000000000000110110000000000
11011000000000000000000000000000010000000001100000
00000000000000000111001111100000000000000010000000
10110001010000000010000000000001011111011111100000
10000000000000000000000000000000000000000000000000
00000000001011000000000001001110000000000011000000
10011000011000000000000111000011110000000001100000
11011110010000000001000110000000000000110011100101
00000000111100000001100011000000000111100000000101
11110000010000000001100011111111000000010100001101
00000000000011000110001000000000001010010100000001
00000000111111001100000111111100000000000100000001
00100000000000000000000000110000000000000000000000
00000000000000000001110000000000001110100000000000
11111110000000100000000000000000000000000000111111
00000000000000000000000011100000100000000000000000
00000000000000111000000000000000000000000000000000
11000110011000000000000000010111011001110001011111
10010010111101000110000000000000000000000000000000
00000000001000110011100000000000011111111100000000
01000011110010000000000000000000000111110000000000
11001000000000000000000000000000010000000001100000
00000000000000000111100011100000000001000000000000
10110001010000000010000000000101011111000111100000
10000000000000000000000000000000000000000000000000
00000000001111000000000001100110000000000011000000
10011000010000000000000110000011110000000001100000
11011110010000000001110000000000000000111110000101
11000010111000000000111111100000001100000000101010
11100000010010000010000000001000001000001111000001
00000000000011001100011000000000001000010011000011
00000000111011100000000110110100000000000001001111
00000000000000000000000000110000000000000000000000
00000000000000000001110000000000001111100000000000
11101110000000100000000000000000000000000000111111
00000000000000000000000000000000000000000000000000
00000000000000000000000000000000000000000000000000
11110000111000000000000000010110000011110101011111
10000000000000000110000000000000000000000000000000
