1111111111Lst1111111111111111
10000000000000000000011111111
11111100000000000000000000000
111111      11111111111111111111
111   111111111111111  11111111
1111111111  1111111
0000000000
11only 1 represent the block
1111111111111111111111111111111



